3
5 5
#####
#...O
#.#.#
#...#
#####
10 10
#O########
#...#.####
###.#....#
#...####.#
#.###....#
#...#.####
###.#....#
###..###.#
####.....#
##########
3 5
##O##
#...#
#####